1 1 0 0 0 0 4 5 4 4 5 4 4 5 4 9
 2 1 0 0 0 4 9 9 4 4 5 4 4 5 4 4
2 1 0 0 0 4 7 6 8 4 4 4 4 4 4 4
 2 1 0 0 4 7 6 6 8 9 9 9 9 9 9 5
2 2 2 2 4 7 6 6 6 4 4 4 4 4 5 4
 2 2 2 4 7 6 6 6 4 0 0 3 0 3 0 0
4 3 1 4 7 6 6 6 5 0 0 2 2 2 2 0
 4 4 4 7 6 6 6 8 5 1 1 1 0 0 0 0
9 5 5 4 5 5 5 4 4 1 3 1 1 1 1 1