2 0 9 9 9 9 9 9 9 9 9 9 9 9 9 9
 2 0 6 6 0 0 1 1 0 0 6 6 6 6 6 8
2 0 7 6 0 0 1 1 0 0 7 6 4 4 4 6
 2 0 6 8 0 0 9 9 0 0 6 8 4 4 4 8
2 0 7 6 2 2 7 6 2 0 7 6 8 9 9 7
 2 0 6 8 2 2 6 8 2 1 6 6 6 6 6 8
5 0 7 6 0 9 7 6 5 5 3 6 1 0 0 0
 4 0 4 4 0 5 6 8 4 4 4 4 4 4 0
5 4 3 3 3 0 9 7 6 8 9 9 9 9 4 0