2 3 0 0 0 0 4 9 1 1 0 0 0 0 0 0
 2 3 0 0 0 4 7 8 9 1 0 0 3 0 0 0
2 3 0 0 0 0 5 6 6 4 0 0 3 3 0 0
 2 3 0 0 0 0 0 4 5 0 0 0 3 3 0 0
2 2 2 2 2 2 4 4 4 0 0 0 3 0 0 0
 2 2 2 2 2 2 4 9 4 4 0 0 0 0 0 0
4 1 4 4 4 4 9 7 8 4 0 0 1 1 0 1
 4 4 4 4 4 7 6 6 8 9 4 0 0 1 1 1
5 4 4 5 9 7 6 5 5 6 8 5 0 3 1 1