5 4 4 4 4 4 4 5 4 4 4 4 4 4 5 5
 4 4 4 4 4 4 1 1 1 0 4 4 5 4 4 4
4 5 4 4 5 2 1 1 1 2 2 0 4 4 4 4
 5 4 4 4 0 1 9 9 9 3 2 4 4 4 4 4
4 4 4 4 4 0 7 6 6 8 2 2 4 4 4 4
 4 4 4 4 2 2 6 6 6 3 2 5 4 4 4 4
4 4 4 5 4 4 0 1 3 1 0 4 4 4 4 4
 4 4 4 5 4 4 4 4 5 4 4 5 4 4 4 4
5 4 5 4 4 4 5 4 4 4 4 4 4 4 4 4