2 1 3 0 4 9 9 9 9 9 9 9 9 9 9 9
 2 1 0 0 4 4 4 4 6 6 6 5 5 6 6 8
4 4 4 4 0 3 2 1 4 6 6 8 5 7 6 6
 9 9 9 5 4 4 4 4 4 5 6 8 7 6 6 8
7 6 6 8 4 4 5 4 4 4 4 4 6 6 6 5
 6 6 2 8 9 9 9 4 4 4 9 4 6 6 4 4
7 6 8 7 6 6 6 8 5 4 7 8 7 6 4 0
 6 6 6 6 6 6 6 8 9 4 4 4 3 2 1 0
7 6 4 4 4 5 4 6 6 8 4 4 4 0 2 1